 ______   ______   ______   ________   __       ______      
/_____/\ /_____/\ /_____/\ /_______/\ /_/\     /_____/\     
\:::_ \ \\::::_\/_\:::_ \ \\::: _  \ \\:\ \    \::::_\/_    
 \:(_) \ \\:\/___/\\:\ \ \ \\::(_)  \ \\:\ \    \:\/___/\   
  \: ___\/ \::___\/_\:\ \ \ \\:: __  \ \\:\ \____\::___\/_  
   \ \ \    \:\____/\\:\/.:| |\:.\ \  \ \\:\/___/\\:\____/\ 
    \_\/     \_____\/ \____/_/ \__\/\__\/ \_____\/ \_____\/ 
                                                            